height 41
width 39
map
.@.@.@.@.@.@.@.@.@.@.@.@.@.@.@.@.@.@.@.@.
.........................................
@.......................................@
.........................................
@.......................................@
.........................................
.........................................
.........................................
.@@@@..@@@@..@@@@..@@@@..@@@@............
.@@@...@@@...@@@...@@@...@@@.............
.@@@@..@@@@..@@@@..@@@@..@@@@............
.........................................
.........................................
.@@@@..@@@@..@@@@..@@@@..@@@@............
.@@@...@@@...@@@...@@@...@@@.............
.@@@@..@@@@..@@@@..@@@@..@@@@............
.........................................
.........................................
.@@@@..@@@@..@@@@..@@@@..@@@@............
.@@@...@@@...@@@...@@@...@@@.............
.@@@@..@@@@..@@@@..@@@@..@@@@.....@@@....
...................................@.....
..................................@@@....
.@@@@..@@@@..@@@@..@@@@..@@@@......@.....
.@@@...@@@...@@@...@@@...@@@......@@@....
.@@@@..@@@@..@@@@..@@@@..@@@@............
.........................................
.........................................
.@@@@..@@@@..@@@@..@@@@..@@@@.....@@@....
.@@@...@@@...@@@...@@@...@@@.......@.....
.@@@@..@@@@..@@@@..@@@@..@@@@.....@@@....
...................................@.....
..................................@@@....
.........................................
.........................................
.........................................
.........................................
.........................................
.........................................
